file = new AppendToFile();PokerStars Hand #106899440761:  Hold'em No Limit (€0.05/€0.10 EUR) - 2013/11/12 14:47:28 WET [2013/11/12 9:47:28 ET]
Table 'Endeavour III' 6-max Seat #4 is the button
Seat 1: Sc0rpion149 (€17.80 in chips) 
Seat 3: rivit76 (€10.45 in chips) 
Seat 4: clauss90 (€14.12 in chips) 
Seat 5: ordovirtutum (€4.50 in chips) 
Seat 6: dj111992 (€3.68 in chips) 
ordovirtutum: posts small blind €0.05
dj111992: posts big blind €0.10
*** HOLE CARDS ***
Sc0rpion149: folds 
rivit76: raises €0.20 to €0.30
clauss90: folds 
ordovirtutum: folds 
dj111992: folds 
Uncalled bet (€0.20) returned to rivit76
rivit76 collected €0.25 from pot
*** SUMMARY ***
Total pot €0.25 | Rake €0 
Seat 1: Sc0rpion149 folded before Flop (didn't bet)
Seat 3: rivit76 collected (€0.25)
Seat 4: clauss90 (button) folded before Flop (didn't bet)
Seat 5: ordovirtutum (small blind) folded before Flop
Seat 6: dj111992 (big blind) folded before Flop
/*
 * To change this license header, choose License Headers in Project Properties.
 * To change this template file, choose Tools | Templates
 * and open the template in the editor.
 */

package ps;

import java.awt.datatransfer.Clipboard;
import java.awt.datatransfer.ClipboardOwner;
import java.awt.datatransfer.Transferable;
import java.awt.datatransfer.StringSelection;
import java.awt.datatransfer.DataFlavor;
import java.awt.datatransfer.UnsupportedFlavorException;
import java.awt.Toolkit;
import java.io.*;

public final class ClipboardPs implements ClipboardOwner {

    AppendToFile file;
    String oldcopyhand = "";
    String newcopyhand = "";
    
  public void ClipboardPs(){
    ClipboardPs textTransfer = new ClipboardPs();

    //display what is currently on the clipboard
    //System.out.println("Clipboard contains:" + textTransfer.getClipboardContents());
    
    newcopyhand = textTransfer.getClipboardContents().toString();
    
    if(newcopyhand.equals(oldcopyhand))
    {
        
    }else{
        file = new AppendToFile();
        file.AppendToFile(newcopyhand);
        oldcopyhand = newcopyhand;
    }
    //change the contents and then re-display
    //textTransfer.setClipboardContents("blah, blah, blah");
    //System.out.println("Clipboard contains:" + textTransfer.getClipboardContents());
  }

   /**
   * Empty implementation of the ClipboardOwner interface.
   */
   @Override public void lostOwnership(Clipboard aClipboard, Transferable aContents){
     //do nothing
   }

  /**
  * Place a String on the clipboard, and make this class the
  * owner of the Clipboard's contents.
  */
  public void setClipboardContents(String aString){
    StringSelection stringSelection = new StringSelection(aString);
    Clipboard clipboard = Toolkit.getDefaultToolkit().getSystemClipboard();
    clipboard.setContents(stringSelection, this);
  }

  /**
  * Get the String residing on the clipboard.
  *
  * @return any text found on the Clipboard; if none found, return an
  * empty String.
  */
  public String getClipboardContents() {
    String result = "";
    Clipboard clipboard = Toolkit.getDefaultToolkit().getSystemClipboard();
    //odd: the Object param of getContents is not currently used
    Transferable contents = clipboard.getContents(null);
    boolean hasTransferableText =
      (contents != null) &&
      contents.isDataFlavorSupported(DataFlavor.stringFlavor)
    ;
    if (hasTransferableText) {
      try {
        result = (String)contents.getTransferData(DataFlavor.stringFlavor);
      }
      catch (UnsupportedFlavorException | IOException ex){
        System.out.println(ex);
        ex.printStackTrace();
      }
    }
    return result;
  }
}PokerStars Hand #106899567233:  Hold'em No Limit (€0.05/€0.10 EUR) - 2013/11/12 14:50:36 WET [2013/11/12 9:50:36 ET]
Table 'Endeavour III' 6-max Seat #2 is the button
Seat 1: Sc0rpion149 (€15.70 in chips) 
Seat 2: piki403 (€3.40 in chips) 
Seat 3: rivit76 (€10 in chips) 
Seat 4: clauss90 (€16.17 in chips) 
Seat 5: ordovirtutum (€4.45 in chips) 
Seat 6: dj111992 (€3.43 in chips) 
rivit76: posts small blind €0.05
clauss90: posts big blind €0.10
*** HOLE CARDS ***
ordovirtutum: folds 
dj111992: calls €0.10
Sc0rpion149: folds 
piki403: folds 
rivit76: calls €0.05
clauss90: checks 
*** FLOP *** [Jc 2h 5c]
rivit76: checks 
clauss90: bets €0.30
dj111992: folds 
rivit76: raises €0.90 to €1.20
clauss90: calls €0.90
*** TURN *** [Jc 2h 5c] [4h]
rivit76: bets €2.50
clauss90: calls €2.50
*** RIVER *** [Jc 2h 5c 4h] [7h]
rivit76: checks 
clauss90: bets €2.85
rivit76: calls €2.85
*** SHOW DOWN ***
clauss90: shows [6c Qc] (high card Queen)
rivit76: shows [5h 5d] (three of a kind, Fives)
rivit76 collected €12.80 from pot
*** SUMMARY ***
Total pot €13.40 | Rake €0.60 
Board [Jc 2h 5c 4h 7h]
Seat 1: Sc0rpion149 folded before Flop (didn't bet)
Seat 2: piki403 (button) folded before Flop (didn't bet)
Seat 3: rivit76 (small blind) showed [5h 5d] and won (€12.80) with three of a kind, Fives
Seat 4: clauss90 (big blind) showed [6c Qc] and lost with high card Queen
Seat 5: ordovirtutum folded before Flop (didn't bet)
Seat 6: dj111992 folded on the Flop
PokerStars Hand #106899528135:  Hold'em No Limit (€0.05/€0.10 EUR) - 2013/11/12 14:49:37 WET [2013/11/12 9:49:37 ET]
Table 'Endeavour III' 6-max Seat #1 is the button
Seat 1: Sc0rpion149 (€15.70 in chips) 
Seat 2: piki403 (€2.76 in chips) 
Seat 3: rivit76 (€10.60 in chips) 
Seat 4: clauss90 (€16.17 in chips) 
Seat 5: ordovirtutum (€4.45 in chips) 
Seat 6: dj111992 (€3.53 in chips) 
piki403: posts small blind €0.05
rivit76: posts big blind €0.10
*** HOLE CARDS ***
clauss90: folds 
ordovirtutum: folds 
dj111992: calls €0.10
Sc0rpion149: folds 
piki403: calls €0.05
rivit76: raises €0.50 to €0.60
dj111992: folds 
piki403: calls €0.50
*** FLOP *** [Js 7d 4c]
piki403: bets €1
rivit76: folds 
Uncalled bet (€1) returned to piki403
piki403 collected €1.24 from pot
piki403: doesn't show hand 
*** SUMMARY ***
Total pot €1.30 | Rake €0.06 
Board [Js 7d 4c]
Seat 1: Sc0rpion149 (button) folded before Flop (didn't bet)
Seat 2: piki403 (small blind) collected (€1.24)
Seat 3: rivit76 (big blind) folded on the Flop
Seat 4: clauss90 folded before Flop (didn't bet)
Seat 5: ordovirtutum folded before Flop (didn't bet)
Seat 6: dj111992 folded before Flop
